21111111111111111111111111111111111111111111111112
10000000000000000000000000000000000000000000000001
10000000000000000000000000000000000000000000000001
10000000000000000000000000000000000000000000000001
10000000000000000000000000000000000000000000000001
10000000000000000000000010000000000000000000000001
10000000000000000000000010000000000000000000000001
10000000000000000000000010000000000000000000000001
10000000000000000000000010000000000000000000000001
10000000000000000000000010000000000000000000000001
10000000011111111111111121111111111111111000000001
10000000000000000000000010000000000000000000000001
10000000000000000000000010000000000000000000000001
10000000000000000000000010000000000000000000000001
10000000000000000000000010000000000000000000000001
10000000000000000000000010000000000000000000000001
10000000000000000000000000000000000000000000000001
10000000000000000000000000000000000000000000000001
10000000000000000000000000000000000000000000000001
10000000000000000000000000000000000000000000000001
21111111111111111111111111111111111111111111111112