21111111111111111111111111111111111111111111111112
10000000000000000000000000000000000000000000000001
10000000000000000000000000000000000000000000000001
10000000000000000000000000000000000000000000000001
10000010000000000000010000000000000000000000000001
10000010000000000000010000000000000000000000000001
10000010000000000000010000000000000000000000000001
10000010000000000000010000211111111111111112000001
10000010000000000000010000100000000000000001000001
10000010000000000000010000100000000000000001000001
10000010000000000000010000100000000000000001000001
10000010000000000000010000100000000000000001000001
10000010000000000000010000100000000000000001000001
10000021111111111111120000100000000000000001000001
10000000000000000000000000100000000000000001000001
10000000000000000000000000100000000000000001000001
10000000000000000000000000100000000000000001000001
10000000000000000000000000000000000000000000000001
10000000000000000000000000000000000000000000000001
10000000000000000000000000000000000000000000000001
21111111111111111111111111111111111111111111111112