21111111111111111111111111111111111111111111111112
10000000000000000000000000000000000000000000000001
10000000000000000000000000000000000000000000000001
10000000000000000000000000000000000000000000000001
10000000000000000000000000000000000000000000000001
10000002111111111111111111111111111111111120000001
10000001000000100000010000001000000100000010000001
10000001000000100000000000000000000100000010000001
10000001000000000000010000001000000000000010000001
10000001000000100000010000001000000100000010000001
10000000000000100000000000000000000100000000000001
10000001000000100000010000001000000100000010000001
10000001000000000000010000001000000100000010000001
10000001000000100000000000000000000000000010000001
10000001000000100000010000001000000100000010000001
10000002111111111111111111111111111111111120000001
10000000000000000000000000000000000000000000000001
10000000000000000000000000000000000000000000000001
10000000000000000000000000000000000000000000000001
10000000000000000000000000000000000000000000000001
21111111111111111111111111111111111111111111111112